##E...T#..
#..#.#..E.
#.##S##EE.
#..#E#..#.
G..#.##...