#.T..E...#
#.#...##G#
#.#.#.##.#
#S#E.###.#
#.T.#...#.