##E...T#.E
#..###.T..
#.##S##E..
#E.#.E..#.
G.T#T###.T