##E...T#.E
#..###.T..
#.#TS##E..
#E.#.E..#.
G.T#T###.T