E.T..E...E
..##T.##..
.T#T###T..
.#.E..T#E.
E.T.#.TS#G